-2	16	0	-2	16	0	-2	16	0	-2	16	0	-2	16	0	-2	16	0	-2	16	0	-2	16	0	-2	16	0	-2	16	0	-2	16	0	-2	16	0	-2	16	0	-2	16	0	-2	16	0	-2	16	0	-2	16	0	-2	16	0	-2	16	34	-2	19	72	-2	19	34	-2	16	72	-2	16	0	-2	16	0	-2	16	0	-2	16	0	-2	16	0	-2	16	0	-2	16	0	-2	16	0	-2	16	0	-2	16	0	-2	16	0	-2	16	0	-2	16	0	-2	16	0	-2	16	0	-2	16	0	-2	16	0	-2	16	0
-2	16	0	-2	16	0	-2	16	0	-2	16	0	-2	16	0	-2	16	0	-2	16	0	-2	16	0	-2	16	0	-2	16	0	-2	16	0	-2	16	0	-2	16	0	-2	16	0	-2	16	0	-2	16	0	-2	16	0	-2	16	0	-2	16	50	-2	19	-56	-2	19	50	-2	16	-56	-2	16	0	-2	16	0	-2	16	0	-2	16	0	-2	16	0	-2	16	0	-2	16	0	-2	16	0	-2	16	0	-2	16	0	-2	16	0	-2	16	0	-2	16	0	-2	16	0	-2	16	0	-2	16	0	-2	16	0	-2	16	0
-2	16	0	-2	16	0	-2	16	0	-2	16	0	-2	16	0	-2	16	0	-2	16	0	-2	16	0	-2	16	0	-2	16	0	-2	16	0	-2	16	0	-2	16	0	-2	16	0	-2	16	0	-2	16	0	-2	16	0	-2	16	0	-2	16	50	-2	19	-56	-2	19	50	-2	16	-56	-2	16	0	-2	16	0	-2	16	0	-2	16	0	-2	16	0	-2	16	0	-2	16	0	-2	16	0	-2	16	0	-2	16	0	-2	16	0	-2	16	0	-2	16	0	-2	16	0	-2	16	0	-2	16	0	-2	16	0	-2	16	0
-2	16	0	-2	16	0	-2	16	0	-2	16	0	-2	16	0	-2	16	0	-2	16	0	-2	16	0	-2	16	0	-2	16	0	-2	16	0	-2	16	0	-2	16	0	-2	16	0	-2	16	0	-2	16	0	-2	16	0	-2	16	0	-2	16	50	-2	19	-56	-2	19	50	-2	16	-56	-2	16	0	-2	16	0	-2	16	0	-2	16	0	-2	16	0	-2	16	0	-2	16	0	-2	16	0	-2	16	0	-2	16	0	-2	16	0	-2	16	0	-2	16	0	-2	16	0	-2	16	0	-2	16	0	-2	16	0	-2	16	0
-2	16	0	-2	16	0	-2	16	0	-2	16	0	-2	16	0	-2	16	0	-2	16	0	-2	16	0	-2	16	0	-2	16	0	-2	16	0	-2	16	0	-2	16	0	-2	16	0	-2	16	0	-2	16	0	-2	16	0	-2	16	0	-2	16	50	-2	19	-56	-2	19	50	-2	16	-56	-2	16	0	-2	16	0	-2	16	0	-2	16	0	-2	16	0	-2	16	0	-2	16	0	-2	16	0	-2	16	0	-2	16	0	-2	16	0	-2	16	0	-2	16	0	-2	16	0	-2	16	0	-2	16	0	-2	16	0	-2	16	0
-2	16	0	-2	16	0	-2	16	0	-2	16	0	-2	16	0	-2	16	0	-2	16	0	-2	16	0	-2	16	0	-2	16	0	-2	16	0	-2	16	0	-2	16	0	-2	16	0	-2	16	0	-2	16	0	-2	16	0	-2	16	0	-2	16	50	-2	19	-56	-2	19	50	-2	16	-56	-2	16	0	-2	16	0	-2	16	0	-2	16	0	-2	16	0	-2	16	0	-2	16	0	-2	16	0	-2	16	0	-2	16	0	-2	16	0	-2	16	0	-2	16	0	-2	16	0	-2	16	0	-2	16	0	-2	16	0	-2	16	0
-2	16	0	-2	16	0	-2	16	0	-2	16	0	-2	16	0	-2	16	0	-2	16	0	-2	16	0	-2	16	0	-2	16	0	-2	16	0	-2	16	0	-2	16	0	-2	16	0	-2	16	0	-2	16	0	-2	16	0	-2	16	0	-2	16	50	-2	19	-56	-2	19	50	-2	16	-56	-2	16	0	-2	16	0	-2	16	0	-2	16	0	-2	16	0	-2	16	0	-2	16	0	-2	16	0	-2	16	0	-2	16	0	-2	16	0	-2	16	0	-2	16	0	-2	16	0	-2	16	0	-2	16	0	-2	16	0	-2	16	0
-2	16	36	-2	16	100	-2	16	100	-2	16	100	-2	16	100	-2	16	100	-2	16	100	-2	16	100	-2	16	100	-2	16	100	-2	16	100	-2	16	100	-2	16	100	-2	16	100	-2	16	100	-2	16	100	-2	16	100	-2	16	100	-2	16	118	-2	19	-120	-2	19	18	-2	16	-52	-2	16	64	-2	16	0	-2	16	0	-2	16	0	-2	16	0	-2	16	0	-2	16	0	-2	16	0	-2	16	0	-2	16	0	-2	16	0	-2	16	0	-2	16	0	-2	16	0	-2	16	0	-2	16	0	-2	16	0	-2	16	0
-2	19	17	-2	19	-111	-2	19	-111	-2	19	-111	-2	19	-111	-2	19	-111	-2	19	-111	-2	19	-111	-2	19	-111	-2	19	-111	-2	19	-111	-2	19	-111	-2	19	-111	-2	19	-111	-2	19	-111	-2	19	-111	-2	19	-111	-2	19	-111	-2	19	-127	-2	19	-128	-2	19	16	-2	19	51	-2	16	72	-2	16	0	-2	16	0	-2	16	0	-2	16	0	-2	16	0	-2	16	0	-2	16	0	-2	16	0	-2	16	0	-2	16	0	-2	16	0	-2	16	0	-2	16	0	-2	16	0	-2	16	0	-2	16	0	-2	16	0
-2	19	36	-2	19	100	-2	19	100	-2	19	100	-2	19	100	-2	19	100	-2	19	100	-2	19	100	-2	19	100	-2	19	100	-2	19	100	-2	19	100	-2	19	100	-2	19	100	-2	19	68	-2	19	64	-2	19	0	-2	19	32	-2	19	36	-2	19	100	-2	19	100	-2	19	118	-2	16	-120	-2	16	0	-2	16	0	-2	16	0	-2	16	0	-2	16	0	-2	16	0	-2	16	0	-2	16	0	-2	16	0	-2	16	0	-2	16	0	-2	16	0	-2	16	0	-2	16	0	-2	16	0	-2	16	0	-2	16	0
-2	16	17	-2	16	-111	-2	16	-111	-2	16	-111	-2	16	-111	-2	16	-111	-2	16	-111	-2	16	-111	-2	16	-111	-2	16	-111	-2	16	-111	-2	16	-111	-2	16	-111	-2	16	-111	-2	16	-77	-2	19	72	-2	19	0	-2	19	34	-2	16	-39	-2	16	-111	-2	16	-111	-2	16	-127	-2	16	-128	-2	16	0	-2	16	0	-2	16	0	-2	16	0	-2	16	0	-2	16	0	-2	16	0	-2	16	0	-2	16	0	-2	16	0	-2	16	0	-2	16	0	-2	16	0	-2	16	0	-2	16	0	-2	16	0	-2	16	0
-2	16	0	-2	16	0	-2	16	0	-2	16	0	-2	16	0	-2	16	0	-2	16	0	-2	16	0	-2	16	0	-2	16	0	-2	16	0	-2	16	0	-2	16	0	-2	16	0	-2	16	50	-2	19	-56	-2	19	0	-2	19	50	-2	16	-56	-2	16	0	-2	16	0	-2	16	0	-2	16	0	-2	16	0	-2	16	0	-2	16	0	-2	16	0	-2	16	0	-2	16	0	-2	16	0	-2	16	0	-2	16	0	-2	16	0	-2	16	0	-2	16	0	-2	16	0	-2	16	0	-2	16	0	-2	16	0	-2	16	0
-2	16	0	-2	16	0	-2	16	0	-2	16	0	-2	16	0	-2	16	0	-2	16	0	-2	16	0	-2	16	0	-2	16	0	-2	16	0	-2	16	0	-2	16	0	-2	16	0	-2	16	50	-2	19	-56	-2	19	0	-2	19	50	-2	16	-56	-2	16	0	-2	16	0	-2	16	0	-2	16	32	-2	16	36	-2	16	100	-2	16	100	-2	16	100	-2	16	100	-2	16	68	-2	16	64	-2	16	0	-2	16	0	-2	16	0	-2	16	0	-2	16	0	-2	16	0	-2	16	0	-2	16	0	-2	16	0	-2	16	0
-2	16	0	-2	16	0	-2	16	0	-2	16	0	-2	16	0	-2	16	0	-2	16	0	-2	16	0	-2	16	0	-2	16	0	-2	16	0	-2	16	0	-2	16	0	-2	16	0	-2	16	50	-2	19	-56	-2	19	0	-2	19	50	-2	16	-56	-2	16	0	-2	16	0	-2	16	0	-2	16	34	-2	67	9	-2	67	1	-2	67	1	-2	67	1	-2	67	1	-2	67	3	-2	16	72	-2	16	0	-2	16	0	-2	16	0	-2	16	0	-2	16	0	-2	16	0	-2	16	0	-2	16	0	-2	16	0	-2	16	0
-2	16	0	-2	16	0	-2	16	0	-2	16	0	-2	16	0	-2	16	0	-2	16	0	-2	16	0	-2	16	0	-2	16	0	-2	16	0	-2	16	0	-2	16	0	-2	16	0	-2	16	50	-2	19	-56	-2	19	0	-2	19	50	-2	16	-56	-2	16	0	-2	16	0	-2	16	0	-2	16	50	-2	67	12	-2	67	4	-2	67	4	-2	67	4	-2	67	4	-2	67	6	-2	16	-56	-2	16	0	-2	16	0	-2	16	0	-2	16	0	-2	16	0	-2	16	0	-2	16	0	-2	16	0	-2	16	0	-2	16	0
-2	16	0	-2	16	0	-2	16	0	-2	16	0	-2	16	0	-2	16	0	-2	16	0	-2	16	32	-2	16	36	-2	16	100	-2	16	100	-2	16	100	-2	16	100	-2	16	100	-2	16	118	-2	19	-56	-2	19	0	-2	19	50	-2	16	-56	-2	16	0	-2	16	0	-2	16	0	-2	16	50	-2	76	9	-2	76	1	-2	76	1	-2	76	1	-2	76	1	-2	76	3	-2	16	-56	-2	16	0	-2	16	0	-2	16	0	-2	16	0	-2	16	0	-2	16	0	-2	16	0	-2	16	0	-2	16	0	-2	16	0
-2	16	0	-2	16	0	-2	16	0	-2	16	0	-2	16	0	-2	16	0	-2	16	0	-2	16	34	-2	33	-39	-2	33	-111	-2	33	-111	-2	33	-111	-2	33	-111	-2	33	-111	-2	33	-77	-2	19	-56	-2	19	0	-2	19	18	-2	16	-20	-2	16	100	-2	16	100	-2	16	100	-2	16	118	-2	76	12	-2	76	4	-2	76	4	-2	76	4	-2	76	4	-2	76	6	-2	16	-20	-2	16	100	-2	16	100	-2	16	68	-2	16	64	-2	16	0	-2	16	0	-2	16	0	-2	16	0	-2	16	0	-2	16	0
-2	16	0	-2	16	0	-2	16	0	-2	16	0	-2	16	0	-2	16	0	-2	16	0	-2	16	50	-2	33	-56	-2	33	0	-2	33	0	-2	33	0	-2	33	0	-2	33	0	-2	33	50	-2	19	-56	-2	19	0	-2	19	16	-2	19	17	-2	19	-111	-2	19	-111	-2	19	-111	-2	19	-111	-2	19	-111	-2	19	-111	-2	19	-111	-2	19	-111	-2	19	-111	-2	19	-111	-2	19	-111	-2	19	-111	-2	19	-111	-2	19	-77	-2	16	72	-2	16	0	-2	16	0	-2	16	0	-2	16	0	-2	16	0	-2	16	0
-2	16	0	-2	16	0	-2	16	0	-2	16	0	-2	16	0	-2	16	0	-2	16	0	-2	16	50	-2	33	-56	-2	33	0	-2	33	0	-2	33	0	-2	33	0	-2	33	0	-2	33	50	-2	19	-56	-2	19	0	-2	19	0	-2	19	0	-2	19	0	-2	19	0	-2	19	0	-2	19	0	-2	19	0	-2	19	0	-2	19	0	-2	19	0	-2	19	0	-2	19	0	-2	19	0	-2	19	0	-2	19	0	-2	19	50	-2	16	-56	-2	16	0	-2	16	0	-2	16	0	-2	16	0	-2	16	0	-2	16	0
-2	16	0	-2	16	0	-2	16	0	-2	16	0	-2	16	0	-2	16	0	-2	16	0	-2	16	50	-2	33	-56	-2	33	0	-2	33	0	-2	33	0	-2	33	0	-2	33	0	-2	33	50	-2	19	-56	-2	19	0	-2	19	0	-2	19	0	-2	19	0	-2	19	0	-2	19	0	-2	19	0	-2	19	0	-2	19	0	-2	19	0	-2	19	0	-2	19	0	-2	19	0	-2	19	0	-2	19	0	-2	19	0	-2	19	50	-2	16	-56	-2	16	0	-2	16	0	-2	16	0	-2	16	0	-2	16	0	-2	16	0
-2	16	0	-2	16	0	-2	16	0	-2	16	0	-2	16	0	-2	16	0	-2	16	0	-2	16	50	-2	33	-56	-2	33	0	-2	33	0	-2	33	0	-2	33	0	-2	33	0	-2	33	50	-2	19	-56	-2	19	0	-2	19	0	-2	19	0	-2	19	0	-2	19	0	-2	19	0	-2	19	0	-2	19	0	-2	19	0	-2	19	0	-2	19	0	-2	19	0	-2	19	0	-2	19	0	-2	19	0	-2	19	0	-2	19	50	-2	16	-56	-2	16	0	-2	16	0	-2	16	0	-2	16	0	-2	16	0	-2	16	0
-2	16	36	-2	16	100	-2	16	100	-2	16	100	-2	16	100	-2	16	100	-2	16	100	-2	16	118	-2	33	-20	-2	33	100	-2	33	100	-2	33	100	-2	33	100	-2	33	100	-2	33	118	-2	19	-120	-2	19	0	-2	19	0	-2	19	0	-2	19	0	-2	19	0	-2	19	0	-2	19	0	-2	19	0	-2	19	0	-2	19	0	-2	19	0	-2	19	0	-2	19	0	-2	19	0	-2	19	0	-2	19	0	-2	19	50	-2	16	-56	-2	16	0	-2	16	0	-2	16	0	-2	16	0	-2	16	0	-2	16	0
-2	19	17	-2	19	-111	-2	19	-111	-2	19	-111	-2	19	-111	-2	19	-111	-2	19	-111	-2	19	-111	-2	19	-111	-2	19	-111	-2	19	-111	-2	19	-111	-2	19	-111	-2	19	-111	-2	19	-127	-2	19	-128	-2	19	0	-2	19	0	-2	19	0	-2	19	0	-2	19	0	-2	19	0	-2	19	0	-2	19	0	-2	19	0	-2	19	0	-2	19	0	-2	19	0	-2	19	0	-2	19	0	-2	19	0	-2	19	0	-2	19	50	-2	16	-56	-2	16	0	-2	16	0	-2	16	0	-2	16	0	-2	16	0	-2	16	0
-2	19	36	-2	19	100	-2	19	100	-2	19	100	-2	19	100	-2	19	100	-2	19	100	-2	19	100	-2	19	100	-2	19	100	-2	19	100	-2	19	100	-2	19	100	-2	19	100	-2	19	68	-2	19	64	-2	19	0	-2	19	0	-2	19	0	-2	19	0	-2	19	0	-2	19	0	-2	19	0	-2	19	0	-2	19	0	-2	19	0	-2	19	0	-2	19	0	-2	19	0	-2	19	0	-2	19	0	-2	19	0	-2	19	50	-2	16	-56	-2	16	0	-2	16	0	-2	16	0	-2	16	0	-2	16	0	-2	16	0
-2	16	17	-2	16	-111	-2	16	-111	-2	16	-111	-2	16	-111	-2	16	-111	-2	16	-111	-2	16	-111	-2	16	-111	-2	16	-111	-2	16	-111	-2	16	-111	-2	16	-111	-2	16	-111	-2	16	-77	-2	19	72	-2	19	0	-2	19	0	-2	19	0	-2	19	0	-2	19	0	-2	19	0	-2	19	0	-2	19	0	-2	19	0	-2	19	0	-2	19	0	-2	19	0	-2	19	0	-2	19	0	-2	19	0	-2	19	0	-2	19	50	-2	16	-56	-2	16	0	-2	16	0	-2	16	0	-2	16	0	-2	16	0	-2	16	0
-2	16	0	-2	16	0	-2	16	0	-2	16	0	-2	16	0	-2	16	0	-2	16	0	-2	16	0	-2	16	0	-2	16	0	-2	16	0	-2	16	0	-2	16	0	-2	16	0	-2	16	50	-2	19	-56	-2	19	0	-2	19	32	-2	19	36	-2	19	100	-2	19	100	-2	19	100	-2	19	100	-2	19	100	-2	19	100	-2	19	100	-2	19	100	-2	19	100	-2	19	100	-2	19	100	-2	19	100	-2	19	100	-2	19	118	-2	16	-120	-2	16	0	-2	16	0	-2	16	0	-2	16	0	-2	16	0	-2	16	0
-2	16	0	-2	16	0	-2	16	0	-2	16	0	-2	16	0	-2	16	0	-2	16	0	-2	16	0	-2	16	0	-2	16	0	-2	16	0	-2	16	0	-2	16	0	-2	16	0	-2	16	50	-2	19	-56	-2	19	0	-2	19	34	-2	16	-39	-2	16	-111	-2	16	-111	-2	16	-111	-2	16	-111	-2	16	-111	-2	16	-111	-2	16	-111	-2	16	-111	-2	16	-111	-2	16	-111	-2	16	-111	-2	16	-111	-2	16	-111	-2	16	-127	-2	16	-128	-2	16	0	-2	16	0	-2	16	0	-2	16	0	-2	16	0	-2	16	0
-2	16	0	-2	16	0	-2	16	0	-2	16	0	-2	16	0	-2	16	0	-2	16	0	-2	16	0	-2	16	0	-2	16	0	-2	16	0	-2	16	0	-2	16	0	-2	16	0	-2	16	50	-2	19	-56	-2	19	0	-2	19	50	-2	16	-56	-2	16	0	-2	16	0	-2	16	0	-2	16	0	-2	16	0	-2	16	0	-2	16	0	-2	16	0	-2	16	0	-2	16	0	-2	16	0	-2	16	0	-2	16	0	-2	16	0	-2	16	0	-2	16	0	-2	16	0	-2	16	0	-2	16	0	-2	16	0	-2	16	0
-2	16	0	-2	16	0	-2	16	0	-2	16	0	-2	16	0	-2	16	0	-2	16	0	-2	16	0	-2	16	0	-2	16	0	-2	16	0	-2	16	0	-2	16	0	-2	16	0	-2	16	50	-2	19	-56	-2	19	0	-2	19	50	-2	16	-56	-2	16	0	-2	16	0	-2	16	0	-2	16	0	-2	16	0	-2	16	0	-2	16	0	-2	16	0	-2	16	0	-2	16	0	-2	16	0	-2	16	0	-2	16	0	-2	16	0	-2	16	0	-2	16	0	-2	16	0	-2	16	0	-2	16	0	-2	16	0	-2	16	0
-2	16	0	-2	16	0	-2	16	0	-2	16	0	-2	16	0	-2	16	0	-2	16	0	-2	16	0	-2	16	0	-2	16	0	-2	16	0	-2	16	0	-2	16	0	-2	16	0	-2	16	18	-2	19	-120	-2	19	0	-2	19	18	-2	16	-120	-2	16	0	-2	16	0	-2	16	0	-2	16	0	-2	16	0	-2	16	0	-2	16	0	-2	16	0	-2	16	0	-2	16	0	-2	16	0	-2	16	0	-2	16	0	-2	16	0	-2	16	0	-2	16	0	-2	16	0	-2	16	0	-2	16	0	-2	16	0	-2	16	0
