-2	0	0	-2	0	0	-2	0	0	-2	0	0	-2	0	0	-2	0	0	-2	0	0	-2	0	0	-2	0	0	-2	0	0	-2	0	0	-2	0	0	-2	0	0	-2	0	0	-2	0	0	-2	0	0	-2	0	0	-2	0	0	-2	0	0	-2	0	0	-2	0	0	-2	0	0	-2	0	0	-2	0	0	-2	0	0	-2	0	0	-2	0	0	-2	0	0	-2	0	0	-2	0	0	-2	0	0	-2	0	0	-2	0	0	-2	0	0	-2	0	0	-2	0	0	-2	0	0	-2	0	0	-2	0	0	-2	0	0
-2	0	0	-2	0	0	-2	0	0	-2	0	0	-2	0	0	-2	0	0	-2	0	0	-2	0	0	-2	0	0	-2	0	0	-2	0	0	-2	0	0	-2	0	0	-2	0	0	-2	0	0	-2	0	0	-2	0	0	-2	0	0	-2	0	0	-2	0	0	-2	0	0	-2	0	0	-2	0	0	-2	0	0	-2	0	0	-2	0	0	-2	0	0	-2	0	0	-2	0	0	-2	0	0	-2	0	0	-2	0	0	-2	0	0	-2	0	0	-2	0	0	-2	0	0	-2	0	0	-2	0	0	-2	0	0	-2	0	0
-2	0	0	-2	0	0	-2	0	0	-2	0	0	-2	0	0	-2	0	0	-2	0	0	-2	0	0	-2	0	0	-2	0	0	-2	0	0	-2	0	0	-2	0	0	-2	0	0	-2	0	0	-2	0	0	-2	0	0	-2	0	0	-2	0	0	-2	0	0	-2	0	0	-2	0	0	-2	0	0	-2	0	0	-2	0	0	-2	0	0	-2	0	0	-2	0	0	-2	0	0	-2	0	0	-2	0	0	-2	0	0	-2	0	0	-2	0	0	-2	0	0	-2	0	0	-2	0	0	-2	0	0	-2	0	0	-2	0	0
-2	0	0	-2	0	0	-2	0	0	-2	0	0	-2	0	0	-2	0	0	-2	0	0	-2	0	0	-2	0	32	-2	0	36	-2	0	100	-2	0	100	-2	0	100	-2	0	68	-2	0	64	-2	0	0	-2	0	0	-2	0	0	-2	0	0	-2	0	0	-2	0	0	-2	0	0	-2	0	0	-2	0	0	-2	0	0	-2	0	0	-2	0	0	-2	0	0	-2	0	0	-2	0	0	-2	0	0	-2	0	0	-2	0	0	-2	0	0	-2	0	0	-2	0	0	-2	0	0	-2	0	0	-2	0	0	-2	0	0
-2	0	0	-2	0	0	-2	0	0	-2	0	0	-2	0	0	-2	0	0	-2	0	0	-2	0	0	-2	0	34	-2	63	9	-2	63	1	-2	63	1	-2	63	1	-2	63	3	-2	0	72	-2	0	0	-2	0	0	-2	0	0	-2	0	0	-2	0	0	-2	0	0	-2	0	0	-2	0	0	-2	0	0	-2	0	0	-2	0	0	-2	0	0	-2	0	0	-2	0	0	-2	0	0	-2	0	0	-2	0	0	-2	0	0	-2	0	0	-2	0	0	-2	0	0	-2	0	0	-2	0	0	-2	0	0	-2	0	0
-2	0	0	-2	0	0	-2	0	0	-2	0	0	-2	0	0	-2	0	0	-2	0	0	-2	0	0	-2	0	50	-2	63	12	-2	63	4	-2	63	4	-2	63	4	-2	63	6	-2	0	-56	-2	0	0	-2	0	0	-2	0	0	-2	0	0	-2	0	0	-2	0	0	-2	0	0	-2	0	0	-2	0	0	-2	0	0	-2	0	0	-2	0	0	-2	0	0	-2	0	0	-2	0	0	-2	0	0	-2	0	0	-2	0	0	-2	0	0	-2	0	0	-2	0	0	-2	0	0	-2	0	0	-2	0	0	-2	0	0
-2	0	0	-2	0	0	-2	0	0	-2	0	0	-2	0	0	-2	0	0	-2	0	0	-2	0	0	-2	0	50	0	4	2	0	4	2	0	4	2	0	4	2	0	4	2	-2	0	-56	-2	0	0	-2	0	0	-2	0	0	-2	0	0	-2	0	0	-2	0	0	-2	0	0	-2	0	0	-2	0	0	-2	0	0	-2	0	0	-2	0	0	-2	0	0	-2	0	0	-2	0	0	-2	0	0	-2	0	0	-2	0	0	-2	0	0	-2	0	0	-2	0	0	-2	0	0	-2	0	0	-2	0	0	-2	0	0
-2	0	0	-2	0	0	-2	0	0	-2	0	0	-2	0	0	-2	0	0	-2	0	0	-2	0	0	-2	0	50	0	4	2	0	4	2	0	4	2	0	4	2	0	4	2	-2	0	-56	-2	0	0	-2	0	0	-2	0	0	-2	0	0	-2	0	0	-2	0	0	-2	0	0	-2	0	0	-2	0	0	-2	0	0	-2	0	0	-2	0	0	-2	0	0	-2	0	0	-2	0	0	-2	0	0	-2	0	0	-2	0	0	-2	0	0	-2	0	0	-2	0	0	-2	0	0	-2	0	0	-2	0	0	-2	0	0
-2	0	0	-2	0	0	-2	0	0	-2	0	0	-2	0	0	-2	0	0	-2	0	0	-2	0	0	-2	0	50	0	4	2	0	4	2	0	4	2	0	4	2	0	4	2	-2	0	-56	-2	0	0	-2	0	0	-2	0	0	-2	0	0	-2	0	0	-2	0	0	-2	0	0	-2	0	0	-2	0	0	-2	0	0	-2	0	0	-2	0	0	-2	0	0	-2	0	0	-2	0	0	-2	0	0	-2	0	0	-2	0	0	-2	0	0	-2	0	0	-2	0	0	-2	0	0	-2	0	0	-2	0	0	-2	0	0
-2	0	0	-2	0	0	-2	0	0	-2	0	0	-2	0	0	-2	0	0	-2	0	0	-2	0	0	-2	0	18	0	4	2	0	4	2	0	4	2	0	4	2	0	4	2	-2	0	-120	-2	0	0	-2	0	0	-2	0	0	-2	0	0	-2	0	0	-2	0	0	-2	0	0	-2	0	0	-2	0	0	-2	0	0	-2	0	0	-2	0	0	-2	0	0	-2	0	0	-2	0	0	-2	0	0	-2	0	0	-2	0	0	-2	0	0	-2	0	0	-2	0	0	-2	0	0	-2	0	0	-2	0	0	-2	0	0
-2	0	0	-2	0	0	-2	0	0	-2	0	0	-2	0	0	-2	0	0	-2	0	0	-2	0	0	-2	0	16	-2	0	17	-2	0	-111	-2	0	-111	-2	0	-111	-2	0	-127	-2	0	-128	-2	0	0	-2	0	0	-2	0	0	-2	0	0	-2	0	0	-2	0	0	-2	0	0	-2	0	0	-2	0	0	-2	0	0	-2	0	0	-2	0	0	-2	0	0	-2	0	0	-2	0	0	-2	0	0	-2	0	0	-2	0	0	-2	0	0	-2	0	0	-2	0	0	-2	0	0	-2	0	0	-2	0	0	-2	0	0
-2	0	0	-2	0	0	-2	0	0	-2	0	0	-2	0	0	-2	0	0	-2	0	0	-2	0	0	-2	0	0	-2	0	0	-2	0	0	-2	0	0	-2	0	0	-2	0	0	-2	0	0	-2	0	0	-2	0	0	-2	0	0	-2	0	0	-2	0	0	-2	0	0	-2	0	0	-2	0	0	-2	0	0	-2	0	0	-2	0	0	-2	0	0	-2	0	0	-2	0	0	-2	0	0	-2	0	0	-2	0	0	-2	0	0	-2	0	0	-2	0	0	-2	0	0	-2	0	0	-2	0	0	-2	0	0	-2	0	0
-2	0	0	-2	0	0	-2	0	0	-2	0	0	-2	0	0	-2	0	0	-2	0	0	-2	0	0	-2	0	0	-2	0	0	-2	0	0	-2	0	0	-2	0	0	-2	0	0	-2	0	0	-2	0	0	-2	0	0	-2	0	0	-2	0	0	-2	0	0	-2	0	0	-2	0	0	-2	0	0	-2	0	0	-2	0	0	-2	0	0	-2	0	0	-2	0	0	-2	0	0	-2	0	0	-2	0	0	-2	0	0	-2	0	0	-2	0	0	-2	0	0	-2	0	0	-2	0	0	-2	0	0	-2	0	0	-2	0	0
-2	0	0	-2	0	0	-2	0	0	-2	0	0	-2	0	0	-2	0	0	-2	0	0	-2	0	0	-2	0	0	-2	0	0	-2	0	0	-2	0	0	-2	0	0	-2	0	0	-2	0	0	-2	0	0	-2	0	0	-2	0	0	-2	0	0	-2	0	0	-2	0	0	-2	0	0	-2	0	0	-2	0	0	-2	0	0	-2	0	0	-2	0	0	-2	0	0	-2	0	0	-2	0	0	-2	0	0	-2	0	0	-2	0	0	-2	0	0	-2	0	0	-2	0	0	-2	0	0	-2	0	0	-2	0	0	-2	0	0
-2	0	0	-2	0	0	-2	0	0	-2	0	0	-2	0	0	-2	0	0	-2	0	0	-2	0	0	-2	0	0	-2	0	0	-2	0	0	-2	0	0	-2	0	0	-2	0	0	-2	0	0	-2	0	0	-2	0	0	-2	0	0	-2	0	0	-2	0	0	-2	0	0	-2	0	0	-2	0	0	-2	0	0	-2	0	0	-2	0	0	-2	0	0	-2	0	0	-2	0	0	-2	0	0	-2	0	0	-2	0	0	-2	0	0	-2	0	0	-2	0	0	-2	0	0	-2	0	0	-2	0	0	-2	0	0	-2	0	0
-2	0	0	-2	0	0	-2	0	0	-2	0	0	-2	0	0	-2	0	0	-2	0	0	-2	0	0	-2	0	0	-2	0	0	-2	0	0	-2	0	0	-2	0	0	-2	0	0	-2	0	0	-2	0	0	-2	0	0	-2	0	0	-2	0	0	-2	0	0	-2	0	0	-2	0	0	-2	0	0	-2	0	0	-2	0	0	-2	0	0	-2	0	0	-2	0	0	-2	0	0	-2	0	0	-2	0	0	-2	0	0	-2	0	0	-2	0	0	-2	0	0	-2	0	0	-2	0	0	-2	0	0	-2	0	0	-2	0	0
-2	0	0	-2	0	0	-2	0	0	-2	0	0	-2	0	0	-2	0	0	-2	0	0	-2	0	0	-2	0	0	-2	0	0	-2	0	0	-2	0	0	-2	0	0	-2	0	0	-2	0	0	-2	0	0	-2	0	0	-2	0	0	-2	0	0	-2	0	0	-2	0	0	-2	0	0	-2	0	0	-2	0	0	-2	0	0	-2	0	0	-2	0	0	-2	0	0	-2	0	0	-2	0	0	-2	0	0	-2	0	0	-2	0	0	-2	0	0	-2	0	0	-2	0	0	-2	0	0	-2	0	0	-2	0	0	-2	0	0
-2	0	0	-2	0	0	-2	0	0	-2	0	0	-2	0	0	-2	0	0	-2	0	0	-2	0	0	-2	0	0	-2	0	0	-2	0	0	-2	0	0	-2	0	0	-2	0	0	-2	0	0	-2	0	0	-2	0	0	-2	0	0	-2	0	0	-2	0	0	-2	0	0	-2	0	0	-2	0	0	-2	0	0	-2	0	0	-2	0	0	-2	0	0	-2	0	0	-2	0	0	-2	0	0	-2	0	0	-2	0	0	-2	0	0	-2	0	0	-2	0	0	-2	0	0	-2	0	0	-2	0	0	-2	0	0	-2	0	0
-2	0	0	-2	0	0	-2	0	0	-2	0	0	-2	0	0	-2	0	0	-2	0	0	-2	0	0	-2	0	0	-2	0	0	-2	0	0	-2	0	0	-2	0	0	-2	0	0	-2	0	0	-2	0	0	-2	0	0	-2	0	0	-2	0	0	-2	0	0	-2	0	0	-2	0	0	-2	0	0	-2	0	0	-2	0	0	-2	0	0	-2	0	0	-2	0	0	-2	0	0	-2	0	0	-2	0	0	-2	0	0	-2	0	0	-2	0	0	-2	0	0	-2	0	0	-2	0	0	-2	0	0	-2	0	0	-2	0	0
-2	0	0	-2	0	0	-2	0	0	-2	0	0	-2	0	0	-2	0	0	-2	0	0	-2	0	0	-2	0	0	-2	0	0	-2	0	0	-2	0	0	-2	0	0	-2	0	0	-2	0	0	-2	0	0	-2	0	0	-2	0	0	-2	0	0	-2	0	0	-2	0	0	-2	0	0	-2	0	0	-2	0	0	-2	0	0	-2	0	0	-2	0	0	-2	0	0	-2	0	0	-2	0	0	-2	0	0	-2	0	0	-2	0	0	-2	0	0	-2	0	0	-2	0	0	-2	0	0	-2	0	0	-2	0	0	-2	0	0
-2	0	0	-2	0	0	-2	0	0	-2	0	0	-2	0	0	-2	0	0	-2	0	0	-2	0	0	-2	0	0	-2	0	0	-2	0	0	-2	0	0	-2	0	0	-2	0	0	-2	0	0	-2	0	0	-2	0	0	-2	0	0	-2	0	0	-2	0	0	-2	0	0	-2	0	0	-2	0	0	-2	0	0	-2	0	0	-2	0	0	-2	0	0	-2	0	0	-2	0	0	-2	0	0	-2	0	0	-2	0	0	-2	0	0	-2	0	0	-2	0	0	-2	0	0	-2	0	0	-2	0	0	-2	0	0	-2	0	0
-2	0	0	-2	0	0	-2	0	0	-2	0	0	-2	0	0	-2	0	0	-2	0	0	-2	0	0	-2	0	0	-2	0	0	-2	0	0	-2	0	0	-2	0	0	-2	0	0	-2	0	0	-2	0	0	-2	0	0	-2	0	0	-2	0	0	-2	0	0	-2	0	0	-2	0	0	-2	0	0	-2	0	0	-2	0	0	-2	0	0	-2	0	0	-2	0	0	-2	0	0	-2	0	0	-2	0	0	-2	0	0	-2	0	0	-2	0	0	-2	0	0	-2	0	0	-2	0	0	-2	0	0	-2	0	0	-2	0	0
-2	0	0	-2	0	0	-2	0	0	-2	0	0	-2	0	0	-2	0	0	-2	0	0	-2	0	0	-2	0	0	-2	0	0	-2	0	0	-2	0	0	-2	0	0	-2	0	0	-2	0	0	-2	0	0	-2	0	0	-2	0	0	-2	0	0	-2	0	0	-2	0	0	-2	0	0	-2	0	0	-2	0	0	-2	0	0	-2	0	0	-2	0	0	-2	0	0	-2	0	0	-2	0	0	-2	0	0	-2	0	0	-2	0	0	-2	0	0	-2	0	0	-2	0	0	-2	0	0	-2	0	0	-2	0	0	-2	0	0
-2	0	0	-2	0	0	-2	0	0	-2	0	0	-2	0	0	-2	0	0	-2	0	0	-2	0	0	-2	0	0	-2	0	0	-2	0	0	-2	0	0	-2	0	0	-2	0	0	-2	0	0	-2	0	0	-2	0	0	-2	0	0	-2	0	0	-2	0	0	-2	0	0	-2	0	0	-2	0	0	-2	0	0	-2	0	0	-2	0	0	-2	0	0	-2	0	0	-2	0	0	-2	0	0	-2	0	0	-2	0	0	-2	0	0	-2	0	0	-2	0	0	-2	0	0	-2	0	0	-2	0	0	-2	0	0	-2	0	0
-2	0	0	-2	0	0	-2	0	0	-2	0	0	-2	0	0	-2	0	0	-2	0	0	-2	0	0	-2	0	0	-2	0	0	-2	0	0	-2	0	0	-2	0	0	-2	0	0	-2	0	0	-2	0	0	-2	0	0	-2	0	0	-2	0	0	-2	0	0	-2	0	0	-2	0	0	-2	0	0	-2	0	0	-2	0	0	-2	0	0	-2	0	0	-2	0	0	-2	0	0	-2	0	0	-2	0	0	-2	0	0	-2	0	0	-2	0	0	-2	0	0	-2	0	0	-2	0	0	-2	0	0	-2	0	0	-2	0	0
-2	0	0	-2	0	0	-2	0	0	-2	0	0	-2	0	0	-2	0	0	-2	0	0	-2	0	0	-2	0	0	-2	0	0	-2	0	0	-2	0	0	-2	0	0	-2	0	0	-2	0	0	-2	0	0	-2	0	0	-2	0	0	-2	0	0	-2	0	0	-2	0	0	-2	0	0	-2	0	0	-2	0	0	-2	0	0	-2	0	0	-2	0	0	-2	0	0	-2	0	0	-2	0	0	-2	0	0	-2	0	0	-2	0	0	-2	0	0	-2	0	0	-2	0	0	-2	0	0	-2	0	0	-2	0	0	-2	0	0
-2	0	0	-2	0	0	-2	0	0	-2	0	0	-2	0	0	-2	0	0	-2	0	0	-2	0	0	-2	0	0	-2	0	0	-2	0	0	-2	0	0	-2	0	0	-2	0	0	-2	0	0	-2	0	0	-2	0	0	-2	0	0	-2	0	0	-2	0	0	-2	0	0	-2	0	0	-2	0	0	-2	0	0	-2	0	0	-2	0	0	-2	0	0	-2	0	0	-2	0	0	-2	0	0	-2	0	0	-2	0	0	-2	0	0	-2	0	0	-2	0	0	-2	0	0	-2	0	0	-2	0	0	-2	0	0	-2	0	0
-2	0	0	-2	0	0	-2	0	0	-2	0	0	-2	0	0	-2	0	0	-2	0	0	-2	0	0	-2	0	0	-2	0	0	-2	0	0	-2	0	0	-2	0	0	-2	0	0	-2	0	0	-2	0	0	-2	0	0	-2	0	0	-2	0	0	-2	0	0	-2	0	0	-2	0	0	-2	0	0	-2	0	0	-2	0	0	-2	0	0	-2	0	0	-2	0	0	-2	0	0	-2	0	0	-2	0	0	-2	0	0	-2	0	0	-2	0	0	-2	0	0	-2	0	0	-2	0	0	-2	0	0	-2	0	0	-2	0	0
-2	0	0	-2	0	0	-2	0	0	-2	0	0	-2	0	0	-2	0	0	-2	0	0	-2	0	0	-2	0	0	-2	0	0	-2	0	0	-2	0	0	-2	0	0	-2	0	0	-2	0	0	-2	0	0	-2	0	0	-2	0	0	-2	0	0	-2	0	0	-2	0	0	-2	0	0	-2	0	0	-2	0	0	-2	0	0	-2	0	0	-2	0	0	-2	0	0	-2	0	0	-2	0	0	-2	0	0	-2	0	0	-2	0	0	-2	0	0	-2	0	0	-2	0	0	-2	0	0	-2	0	0	-2	0	0	-2	0	0
-2	0	0	-2	0	0	-2	0	0	-2	0	0	-2	0	0	-2	0	0	-2	0	0	-2	0	0	-2	0	0	-2	0	0	-2	0	0	-2	0	0	-2	0	0	-2	0	0	-2	0	0	-2	0	0	-2	0	0	-2	0	0	-2	0	0	-2	0	0	-2	0	0	-2	0	0	-2	0	0	-2	0	0	-2	0	0	-2	0	0	-2	0	0	-2	0	0	-2	0	0	-2	0	0	-2	0	0	-2	0	0	-2	0	0	-2	0	0	-2	0	0	-2	0	0	-2	0	0	-2	0	0	-2	0	0	-2	0	0
